110000001
010101010
000110001
101100010
010000010
010001101
100011000
010101010
100000011

