9 7 8 3 1 5 2 6 4 
1 4 3 8 2 6 5 9 7 
6 5 2 9 4 7 8 3 1 
2 3 7 5 8 9 1 4 6 
5 6 4 7 3 1 9 8 2 
8 1 9 2 6 4 7 5 3 
4 2 5 6 7 8 3 1 9 
7 9 1 4 5 3 6 2 8 
3 8 6 1 9 2 4 7 5 