6 2 5 7 4 1 8 3 9
8 4 9 2 3 6 1 7 5
1 3 7 8 5 9 4 6 2
2 8 6 3 1 5 9 4 7
9 5 1 4 7 8 3 2 6
3 7 4 9 6 2 5 8 1
4 6 2 1 9 3 7 5 8
7 9 8 5 2 4 6 1 3
5 1 3 6 8 7 2 9 4