9 2 6 3 7 5 8 4 1
7 5 8 4 6 1 2 3 9
1 4 3 9 2 8 6 7 5
4 3 5 8 1 2 9 6 7
2 1 7 6 5 9 3 8 4
8 6 9 7 4 3 1 5 2
5 7 2 1 3 6 4 9 8
3 8 4 2 9 7 5 1 6
6 9 1 5 8 4 7 2 3