001001011
000100101
011000000
110010111
000000000
111010011
000000110
101001000
110100100