000101100
010000010
001100001
101010001
110101011
100010101
100001100
010000010
001101000