100100111
100010010
001100000
001000011
010101010
110000100
000001100
010010001
111001001