010101000
001101011
011000100
010110000
001000100
000011010
001000110
110101100
000101010