010001100
001110001
101001011
000000010
100111001
010000000
110100101
100011100
001100010
