2 5 1 7 4 3 9 6 8 
9 7 3 8 1 6 4 5 2 
8 4 6 5 2 9 3 1 7 
7 1 8 6 9 5 2 4 3 
5 9 2 1 3 4 8 7 6 
3 6 4 2 7 8 5 9 1 
6 2 5 4 8 1 7 3 9 
4 8 9 3 6 7 1 2 5 
1 3 7 9 5 2 6 8 4 