111011001
100010000
010000010
100001101
010010010
101100001
010000010
000010001
100110111