100010000
010000011
001110101
000010100
101101101
001010000
101011100
110000010
000010001