6 9 1 5 2 8 4 7 3
4 5 2 7 3 9 6 1 8
7 3 8 1 4 6 2 9 5
1 6 7 3 5 4 9 8 2
9 4 5 2 8 7 1 3 6
8 2 3 9 6 1 7 5 4
2 7 4 8 9 3 5 6 1
3 1 6 4 7 5 8 2 9
5 8 9 6 1 2 3 4 7