001000100
101111001
010000100
100101001
010000010
100101001
001000010
100111101
001000100