2 9 4 5 1 7 8 3 6 
1 5 6 4 3 8 2 7 9 
8 7 3 9 2 6 4 5 1 
3 4 1 8 5 2 9 6 7 
9 2 5 6 7 4 1 8 3 
6 8 7 1 9 3 5 2 4 
7 1 9 2 6 5 3 4 8 
4 6 2 3 8 1 7 9 5 
5 3 8 7 4 9 6 1 2 