5 2 1 8 4 3 6 9 7
3 8 9 6 1 7 4 5 2
6 4 7 9 2 5 1 8 3
9 7 8 2 5 1 3 4 6
1 3 4 7 6 8 5 2 9
2 5 6 3 9 4 7 1 8
8 9 5 1 7 6 2 3 4
7 1 2 4 3 9 8 6 5
4 6 3 5 8 2 9 7 1