000110011
010100001
101010100
001001000
110000011
000100100
001010101
100001010
110011000