9 4 5 8 6 2 1 7 3 
2 8 7 5 1 3 9 6 4 
1 6 3 7 9 4 5 8 2 
4 5 1 9 2 7 6 3 8 
6 2 8 3 4 5 7 9 1 
7 3 9 1 8 6 2 4 5 
8 1 6 2 3 9 4 5 7 
3 7 4 6 5 1 8 2 9 
5 9 2 4 7 8 3 1 6 