9 1 3 7 5 8 6 4 2
7 4 5 9 6 2 3 8 1
2 6 8 4 1 3 5 7 9
6 5 9 2 8 1 4 3 7
4 8 7 5 3 9 2 1 6
3 2 1 6 7 4 8 9 5
5 3 4 1 2 7 9 6 8
8 7 2 3 9 6 1 5 4
1 9 6 8 4 5 7 2 3