8 1 6 9 3 4 5 2 7
9 3 2 6 5 7 1 4 8
5 7 4 8 1 2 6 3 9
6 4 3 2 7 1 9 8 5
2 9 8 4 6 5 7 1 3
1 5 7 3 8 9 4 6 2
3 2 5 7 4 6 8 9 1
7 6 9 1 2 8 3 5 4
4 8 1 5 9 3 2 7 6